4,5,5,136,7,3,95,3,317,11,11,8,4,3,60,4,78,60,60,60,3,71,32,63,59,3,32,76,59,3,32,85,59,3,32,22,60,3,32,80,60,3,32,63,52,21,3,32,3,52,43,59,3,60,55,32,63,3,32,63,3,32,63,3,60,32,69,51,71,60,3,32,63,3,32,63,52,69,52,85,52,72,3,60,57,32,63,59,83,3,59,60,55,32,63,3,60,57,32,63,60,3,60,60,60,57,32,63,3,60,58,32,37,3,60,58,32,63,3,59,57,32,63,3,59,57,32,63,3,59,57,32,63,3,32,63,3,32,63,3,32,63,3,32,63,3,32,63,60,3,32,63,52,85,52,80,52,85,52,22,52,21,3,52,43,60,60,3,32,63,58,86,3,59,59,60,55,32,63,3,60,32,63,3,32,63,3,60,60,60,32,65,3,32,63,51,63,52,85,59,87,59,85,52,80,52,85,59,78,59,87,3,51,43,60,3,59,32,63,51,85,60,3,59,60,32,85,3,55,59,32,63,3,60,57,60,60,55,32,23,3,59,60,32,65,60,3,60,55,32,63,3,60,55,55,32,63,3,60,32,85,3,60,60,60,54,32,63,3,59,55,60,60,57,32,63,59,3,60,32,63,60,3,55,32,63,3,60,32,63,59,75,59,55,3,32,63,60,3,32,63,52,79,59,87,3,58,63,60,52,75,
5,6,6,137,8,4,96,4,318,12,12,9,5,4,61,5,79,61,61,61,4,74,33,64,61,4,33,77,61,4,33,86,61,4,33,79,61,4,33,81,61,4,33,64,53,22,4,33,4,53,44,61,4,61,56,33,64,4,33,64,4,33,64,4,61,33,70,52,72,61,4,33,64,4,33,64,53,70,53,86,53,73,4,61,59,33,64,60,84,4,61,61,56,33,64,4,61,59,33,64,61,4,61,61,61,59,33,64,4,61,59,33,38,4,61,59,33,64,4,61,59,33,64,4,61,59,33,64,4,61,59,33,64,4,33,64,4,33,64,4,33,64,4,33,64,4,33,64,61,4,33,64,53,86,53,81,53,86,53,23,53,22,4,53,44,61,61,4,33,64,59,87,4,61,61,61,56,33,64,4,61,33,64,4,33,64,4,61,61,61,33,66,4,33,64,52,64,53,86,60,88,60,86,53,81,53,86,60,79,60,88,4,52,44,61,4,61,33,64,52,86,61,4,61,61,33,86,4,56,61,33,64,4,61,59,61,61,56,33,24,4,61,61,33,66,61,4,61,56,33,64,4,61,56,56,33,64,4,61,33,86,4,61,61,61,55,33,64,4,61,56,61,61,59,33,64,61,4,61,33,64,61,4,56,33,64,4,61,33,64,60,76,60,56,4,33,64,61,4,33,64,53,80,60,88,4,59,64,61,53,76,
6,7,7,138,9,11,97,5,319,13,13,10,6,5,62,6,80,62,63,63,5,76,34,65,62,5,34,78,62,5,34,87,62,5,34,80,62,5,34,82,62,5,34,65,54,23,5,34,5,54,45,62,5,62,57,34,65,5,34,65,5,34,65,5,62,34,71,53,73,63,5,34,65,5,34,65,54,71,54,87,54,74,5,62,60,34,65,61,85,5,62,63,57,34,65,5,62,60,34,65,62,5,62,63,62,60,34,65,5,62,73,34,39,5,62,73,34,65,5,62,60,34,65,5,62,60,34,65,5,62,60,34,65,5,34,65,5,34,65,5,34,65,5,34,65,5,34,65,63,5,34,65,54,87,54,82,54,87,54,24,54,23,5,54,45,63,62,5,34,65,60,88,5,62,62,63,57,34,65,5,62,34,65,5,34,65,5,63,62,63,34,67,5,34,65,53,65,54,87,61,89,61,87,54,82,54,87,61,80,61,89,5,53,45,63,5,62,34,65,53,87,63,5,62,63,34,87,5,57,62,34,65,5,62,60,62,62,57,34,25,5,62,63,34,67,63,5,62,57,34,65,5,62,57,57,34,65,5,62,34,87,5,63,63,63,56,34,65,5,62,57,62,63,60,34,65,62,5,62,34,65,63,5,57,34,65,5,62,34,65,61,77,61,57,5,34,65,63,5,34,65,54,81,61,89,5,60,65,62,54,77,
7,8,8,139,12,98,6,320,14,14,11,7,6,63,7,81,63,64,70,6,77,35,66,63,6,35,79,63,6,35,88,63,6,35,81,63,6,35,83,63,6,35,66,55,24,6,35,6,55,46,63,6,63,58,35,66,6,35,66,6,35,66,6,63,35,72,54,74,64,6,35,66,6,35,66,55,72,55,89,55,75,6,63,61,35,66,63,86,6,63,64,58,35,66,6,63,61,35,66,63,6,63,64,63,61,35,66,6,63,74,35,40,6,63,74,35,66,6,63,61,35,66,6,63,61,35,66,6,63,61,35,66,6,35,66,6,35,66,6,35,66,6,35,66,6,35,66,64,6,35,66,55,88,55,83,55,88,55,25,55,24,6,55,46,64,63,6,35,66,61,89,6,63,63,64,58,35,66,6,63,35,66,6,35,66,6,64,63,64,35,68,6,35,66,54,66,55,88,63,90,63,88,55,83,55,88,63,81,63,90,6,54,46,64,6,63,35,66,54,88,64,6,63,64,35,88,6,58,63,35,66,6,63,61,63,63,58,35,27,6,63,64,35,68,64,6,63,58,35,66,6,63,58,58,35,66,6,63,35,88,6,64,64,64,57,35,66,6,63,58,63,64,61,35,66,63,6,63,35,66,64,6,58,35,66,6,63,35,66,63,78,63,58,6,35,66,64,6,35,66,55,82,63,90,6,61,66,63,55,78,
8,9,9,140,13,99,7,321,15,31,12,8,7,64,8,82,64,65,71,7,78,36,67,67,7,36,80,67,7,36,89,67,7,36,82,67,7,36,84,67,7,36,67,56,82,7,36,7,56,47,67,7,64,59,36,67,7,36,67,7,36,67,7,64,36,73,55,75,65,7,36,67,7,36,67,56,73,56,90,56,76,7,64,75,36,67,64,87,7,64,65,59,36,67,7,64,75,36,67,64,7,64,65,64,75,36,67,7,64,75,36,41,7,64,75,36,67,7,64,75,36,67,7,64,75,36,67,7,64,67,36,67,7,36,67,7,36,67,7,36,67,7,36,67,7,36,67,65,7,36,67,56,89,56,84,56,89,56,82,56,91,7,56,47,65,64,7,36,67,63,90,7,64,64,65,59,36,67,7,64,36,67,7,36,67,7,65,64,65,36,69,7,36,67,55,67,56,89,64,91,64,89,56,84,56,89,64,82,64,91,7,55,47,65,7,64,36,67,55,89,65,7,64,65,36,89,7,59,64,36,67,7,64,75,64,64,59,36,28,7,64,65,36,69,65,7,64,59,36,67,7,64,59,59,36,67,7,64,36,89,7,65,65,65,58,36,67,7,64,59,64,65,75,36,67,64,7,64,36,67,65,7,59,36,67,7,64,36,67,64,79,64,59,7,36,67,65,7,36,67,56,83,64,91,7,62,67,64,56,79,
9,10,10,14,100,8,322,16,32,13,9,8,65,9,83,65,66,72,8,79,37,68,68,8,37,81,68,8,37,90,68,8,37,83,68,8,37,85,68,8,37,68,57,83,8,37,8,57,48,68,8,65,60,37,68,8,37,68,8,37,68,8,65,37,74,56,76,66,8,37,68,8,37,68,58,74,57,92,57,77,8,65,76,37,68,65,88,8,65,66,60,37,68,8,65,76,37,68,65,8,65,66,65,76,37,68,8,65,76,37,42,8,65,76,37,68,8,65,76,37,68,8,65,76,37,68,8,65,69,37,68,8,37,68,8,37,68,8,37,68,8,37,68,8,37,68,66,8,37,68,57,90,57,85,58,90,57,83,57,92,8,57,48,66,65,8,37,68,64,91,8,65,65,66,60,37,68,8,65,37,68,8,37,68,8,66,65,66,37,70,8,37,68,56,68,57,90,65,92,66,90,57,85,57,90,66,83,66,92,8,56,48,66,8,65,37,68,56,90,66,8,65,66,37,90,8,60,65,37,68,8,65,76,65,65,60,37,29,8,65,66,37,70,66,8,65,60,37,68,8,65,60,60,37,68,8,65,37,90,8,66,66,66,59,37,68,8,65,60,65,66,76,37,68,65,8,65,37,68,66,8,60,37,68,8,65,37,68,65,80,66,60,8,37,68,66,8,37,68,57,84,66,92,8,63,68,65,57,80,
64,101,104,373,78,72,70,66,72,60,84,66,71,77,71,81,65,69,69,81,66,82,69,81,58,91,69,70,58,84,69,70,66,86,69,70,66,84,58,84,61,67,63,59,49,69,70,66,61,59,83,70,66,79,71,66,92,81,66,59,100,57,77,73,61,57,79,81,58,92,59,75,58,93,58,78,70,66,77,66,92,66,89,70,66,71,61,66,92,77,66,77,57,71,66,71,66,71,66,77,65,92,61,66,77,64,43,61,66,77,58,94,81,66,77,59,92,70,66,77,66,92,81,66,77,66,92,61,59,92,61,58,75,61,66,92,61,58,74,61,66,92,76,61,57,92,58,91,59,86,59,91,58,84,58,93,61,58,49,76,66,70,59,92,65,92,81,66,66,71,61,66,92,61,66,65,92,77,57,92,70,73,66,71,64,71,81,65,92,57,69,58,91,66,93,67,91,58,86,59,91,67,84,67,93,63,57,49,71,61,66,59,92,57,91,71,77,66,71,58,91,81,61,66,57,92,77,66,77,66,66,61,66,30,61,66,71,57,71,71,70,66,61,59,92,71,66,61,61,59,74,70,66,91,81,71,76,71,60,57,92,61,66,61,66,71,77,66,92,66,71,66,57,87,73,61,61,59,92,61,66,57,79,66,81,67,61,61,58,83,73,61,60,92,58,85,67,93,63,65,78,66,59,81,
