459,13,4,162,4,9,4,7,6,5,6,4,17,34,35,33,7,7,34,25,66,62,33,59,64,
460,14,5,163,5,10,5,8,7,6,7,5,18,35,38,34,8,8,35,26,67,64,34,60,65,
461,15,6,164,6,11,6,9,8,7,8,6,19,36,39,36,9,9,36,27,69,65,37,61,66,
462,16,7,177,7,18,7,10,9,8,9,7,20,37,40,37,10,10,61,28,70,66,38,62,67,
472,17,8,178,8,19,8,11,10,9,10,8,21,38,42,38,11,11,62,29,71,67,39,66,68,
473,18,9,179,9,20,9,12,11,10,11,9,22,39,43,39,12,12,63,30,72,69,64,67,69,
528,30,13,48,29,18,49,101,40,44,40,68,65,31,105,70,65,69,70,
