23,222,26,80,100,49,1110,27,83,3,76,76,
24,223,27,81,101,50,1111,28,84,4,77,77,
25,224,28,82,102,51,1112,29,86,5,78,78,
26,225,29,83,103,52,1113,30,87,6,79,79,
27,226,30,84,104,53,1114,31,88,7,80,80,
28,227,31,85,105,105,1115,32,89,8,81,81,
60,296,111,86,106,106,1182,94,24,82,82,
