3,63,9,78,89,17,11,3,6,56,77,3,88,4,20,20,3,4,5,101,101,10,4,4,97,33,13,12,7,3,66,5,76,675,11,9,3,9,9,20,36,3,3,4,28,5,41,3,4,3,4,6,3,6,4,80,12,7,6,17,3,78,18,3,3,4,17,7,6,6,18,3,3,40,85,18,86,3,62,3,17,7,6,22,18,3,3,17,18,3,17,18,3,17,
4,64,10,79,91,66,12,4,7,57,78,4,89,5,21,21,4,5,6,102,102,11,5,5,98,34,14,13,8,4,67,6,77,676,12,4,10,10,21,37,4,4,5,29,6,42,4,5,4,5,7,4,7,5,81,13,8,7,18,4,79,19,4,4,5,20,8,7,7,19,4,4,41,86,19,87,4,63,4,20,8,7,23,19,4,4,20,19,4,20,19,4,20,
5,65,11,80,92,67,13,5,8,58,79,5,90,6,22,22,5,6,7,103,103,12,6,6,99,35,15,14,9,5,68,7,78,677,13,5,11,11,22,38,5,5,6,30,7,43,5,6,5,6,8,5,8,6,83,14,9,8,22,5,80,20,5,5,6,24,9,8,8,20,5,5,42,87,20,88,5,64,5,24,9,8,24,20,5,5,24,20,5,24,20,5,24,
6,66,12,81,93,68,14,6,9,59,80,6,91,7,23,23,6,7,8,104,104,13,15,7,100,36,16,15,10,6,79,8,79,678,14,6,12,12,23,39,6,6,7,31,8,44,6,7,6,7,9,6,9,7,84,17,13,9,25,6,81,21,6,6,7,25,13,9,9,21,6,6,43,88,21,89,6,65,6,25,10,9,25,21,6,6,25,21,6,25,21,6,25,
7,67,13,82,94,70,15,7,10,60,94,7,94,8,24,24,14,8,9,105,105,19,8,101,37,17,16,7,80,9,80,679,15,7,13,13,24,40,7,7,8,32,9,45,7,8,7,8,10,7,10,8,86,20,14,10,26,7,82,22,7,7,8,27,14,10,10,22,7,7,44,89,22,90,7,66,7,27,11,10,26,22,7,7,27,22,7,27,22,7,27,
8,68,22,83,95,71,16,8,11,61,95,8,95,9,25,25,19,9,10,106,106,20,9,102,38,18,17,8,81,10,81,680,16,8,14,14,25,41,8,8,9,33,10,46,8,9,8,9,11,8,11,9,87,23,15,11,35,8,83,29,8,15,9,28,15,11,11,23,8,8,45,90,29,91,8,67,8,28,12,11,34,29,8,8,28,29,8,28,29,8,28,
77,69,23,84,96,72,76,81,19,62,96,70,97,54,26,80,88,104,107,107,107,76,20,103,39,19,69,18,82,11,82,681,52,12,15,15,26,42,24,41,34,11,47,95,77,108,22,12,56,16,12,88,421,16,12,97,59,84,95,19,24,36,29,16,12,12,24,15,94,46,91,95,92,108,68,40,29,13,12,35,95,103,77,67,95,49,67,95,78,85,
